g0pA_taskb.txt	cut
g0pB_taskc.txt	cut
g0pC_taskd.txt	cut
g0pD_taska.txt	cut
g0pE_taske.txt	cut
g1pA_taskd.txt	cut
g1pB_taske.txt	cut
g1pD_taskb.txt	cut
g2pA_taskd.txt	cut
g2pB_taske.txt	cut
g2pC_taska.txt	cut
g2pE_taskc.txt	cut
g3pA_taskd.txt	cut
g3pB_taske.txt	cut
g3pC_taska.txt	cut
g4pB_taske.txt	cut
g4pC_taska.txt	cut
g4pD_taskb.txt	cut
g4pE_taskc.txt	cut
g0pA_taskd.txt	heavy
g0pB_taske.txt	heavy
g0pC_taska.txt	heavy
g0pD_taskc.txt	heavy
g0pE_taskb.txt	heavy
g1pA_taskb.txt	heavy
g1pB_taskc.txt	heavy
g1pD_taske.txt	heavy
g2pA_taskb.txt	heavy
g2pB_taskc.txt	heavy
g2pC_taskd.txt	heavy
g2pE_taska.txt	heavy
g3pA_taskb.txt	heavy
g3pB_taskc.txt	heavy
g3pC_taskd.txt	heavy
g4pB_taskc.txt	heavy
g4pC_taskd.txt	heavy
g4pD_taske.txt	heavy
g4pE_taska.txt	heavy
g0pA_taskc.txt	light
g0pB_taskd.txt	light
g0pC_taske.txt	light
g0pD_taskb.txt	light
g0pE_taska.txt	light
g1pA_taskc.txt	light
g1pB_taskd.txt	light
g1pD_taska.txt	light
g2pA_taskc.txt	light
g2pB_taskd.txt	light
g2pC_taske.txt	light
g2pE_taskb.txt	light
g3pA_taskc.txt	light
g3pB_taskd.txt	light
g3pC_taske.txt	light
g4pB_taskd.txt	light
g4pC_taske.txt	light
g4pD_taska.txt	light
g4pE_taskb.txt	light
g0pA_taska.txt	non
g0pA_taske.txt	non
g0pB_taska.txt	non
g0pB_taskb.txt	non
g0pC_taskb.txt	non
g0pC_taskc.txt	non
g0pD_taskd.txt	non
g0pD_taske.txt	non
g0pE_taskc.txt	non
g0pE_taskd.txt	non
g1pA_taska.txt	non
g1pA_taske.txt	non
g1pB_taska.txt	non
g1pB_taskb.txt	non
g1pD_taskc.txt	non
g1pD_taskd.txt	non
g2pA_taska.txt	non
g2pA_taske.txt	non
g2pB_taska.txt	non
g2pB_taskb.txt	non
g2pC_taskb.txt	non
g2pC_taskc.txt	non
g2pE_taskd.txt	non
g2pE_taske.txt	non
g3pA_taska.txt	non
g3pA_taske.txt	non
g3pB_taska.txt	non
g3pB_taskb.txt	non
g3pC_taskb.txt	non
g3pC_taskc.txt	non
g4pB_taska.txt	non
g4pB_taskb.txt	non
g4pC_taskb.txt	non
g4pC_taskc.txt	non
g4pD_taskc.txt	non
g4pD_taskd.txt	non
g4pE_taskd.txt	non
g4pE_taske.txt	non
